1
pretentious flamboyant
wallop attack
intimidate - shock
importunate - speaks less, bold , determined
culmination - apex
indemnify - compensate
reimburse -compensate
2
resolute - determined
rue - sad,weeping
purtanical - 
effaced - destroyed
hallowed - holy
3
debacle  - 
rout - destroyed
infirmity - 
incumbernt - manditory
impecunious - poverty
torrid - determined
refulgent - dazziling
sussing - understandable
4
infinitesimal - small
exegetic - explainable
bile - angry
fettle - trim
dross - useless
retort - reply
5
recondite
cadge - beg
scrounge - beg
indigence - poverty
6
intransigent - unsatisfiable
flippant - rude
intrepid - bold
resolute - determined
intemperance - 
discretion- careful
recluse - solitude
7
repudiate - 
restitution - restoration
desicate - urban
consternation - shock, anxious, dismay
inoppurtune
8
nonplussed- 
apprise - inform
dissimulate - 
decieve - fraud
derision - ridicule
emulate mock


final

nonplussed - confused
dissimulate - hide,conceal
inoppurtune - in appropriate
desicate - dehydrated
intemperance - over indulgence
debacle - humiliating failure
purtanical - self disciplined